User,In_Degree,Out_Degree,Degree,Modularity_Class,Page_Rank,Eccentricity_Centrality,Closness_Centrality,Betweeness_Centrality,EigenVector_Centrality
fernandocastor,48,7,55,6,0.01252,8,0.253469,37787.361925,0.751562
filipeximenes,40,32,72,0,0.014185,9,0.26770900000000003,40297.561868,1.0
simoneas02,37,26,63,9,0.011433,10,0.268627,40894.607104,0.211671
renatooliveira,35,28,63,0,0.01055,9,0.25861300000000004,26763.575801,0.994672
lailsonbm,29,1,30,0,0.013151,11,0.149686,1142.658235,0.838433
marcelcaraciolo,28,12,40,0,0.004972,10,0.232203,12484.60924,0.687211
henvic,25,15,40,5,0.011471,8,0.248752,34297.005176,0.585929
guilhermefarias,25,12,37,4,0.00949,9,0.270617,34459.807071,0.451858
guiocavalcanti,24,25,49,0,0.007229999999999999,9,0.263208,24876.026009,0.52449
clovisdasilvaneto,24,5,29,5,0.008796,10,0.225144,8243.218318000001,0.291443
joselitojunior1,23,2,25,6,0.005161,9,0.219025,7591.265970999999,0.30229
arthuralvim,23,46,69,0,0.005947999999999999,9,0.28045,37270.801767,0.642351
gileno,23,15,38,0,0.005235,10,0.240879,4819.658485,0.6925359999999999
fjsj,20,26,46,0,0.003873,9,0.260085,5794.569877,0.617564
talitaoliveira,20,24,44,5,0.00615,10,0.26499,32304.806377,0.226341
mairatma,19,1,20,5,0.005068,9,0.199273,4818.074791,0.305014
gvc,18,5,23,0,0.010609,9,0.2132300000000001,5483.161147999999,0.656756
luiztiago,18,17,35,4,0.006055,9,0.256075,16188.928314,0.466928
pauloborba,16,4,20,6,0.006616,10,0.184512,3426.543826,0.299173
dakerfp,15,1,16,0,0.004535,10,0.211338,1001.620039,0.506877
interaminense,15,29,44,5,0.002557,9,0.267187,8663.450445,0.235529
victorlaerte,14,25,39,5,0.002961,9,0.266537,14957.144835,0.249115
thiagodiniz,14,7,21,0,0.004132,10,0.210931,1984.855355,0.5075390000000001
alsmoreira,14,15,29,7,0.005888,10,0.2453,17447.970676,0.138188
vinicius3w,14,0,14,6,0.005034,0,0.0,0.0,0.15143900000000002
diegonvs,14,30,44,5,0.003825,9,0.257761,16460.411763,0.173652
alexpessoajr,13,30,43,5,0.002395,9,0.256075,8560.967709999999,0.213227
brunofarache,13,2,15,5,0.012928,11,0.163047,5247.572089,0.233073
jordanamorais,12,15,27,5,0.0018,10,0.229673,2791.414011,0.180635
brunnogomes,12,14,26,0,0.002648,10,0.252186,7371.580040999997,0.464207
marcellustavares,12,2,14,5,0.004364,12,0.140513,669.677048,0.263825
irgmedeiros,11,10,21,0,0.002672,9,0.242693,5761.701203000001,0.4307760000000001
leopoldomt,11,4,15,6,0.00479,9,0.2256070000000001,10565.001296,0.19282
WandersonAlves,11,10,21,8,0.004329,11,0.236309,9224.967078,0.096472
brunobasto,11,1,12,5,0.003207,13,0.123229,0.166667,0.232021
karlafalcao,11,22,33,6,0.004385,8,0.28160300000000005,24073.993966,0.166349
lmarinho,11,3,14,0,0.020541,10,0.175979,2701.005063,0.538884
Cisneiros,10,2,12,6,0.00169,10,0.180085,1011.571162,0.086396
miguelarauj1o,10,0,10,6,0.002325,0,0.0,0.0,0.068426
HaysaRodrigues,9,8,17,5,0.001677,10,0.23181,3766.925166,0.118
luanfonceca,9,16,25,0,0.002268,9,0.248301,3098.847753,0.406247
patrickrbc,9,19,28,0,0.0022600000000000003,9,0.25300100000000003,3818.907091,0.4087
gallindo,9,1,10,5,0.00299,11,0.183831,1653.441084,0.096072
filipevarjao,9,9,18,0,0.00268,9,0.237538,5217.282778,0.188251
felipedealbuquerque,9,1,10,12,0.0033950000000000004,10,0.18062,2323.08521,0.05222
roselmamendes,9,17,26,9,0.003027,10,0.21746,8905.416201,0.1649
embs,9,28,37,0,0.001918,9,0.26257800000000003,8333.128819,0.147196
victorcarrico,9,9,18,0,0.002631,9,0.238157,7318.518133,0.280506
araujoraphael,9,6,15,0,0.0019,10,0.212733,556.998658,0.34947399999999995
jeftarmascarenhas,9,4,13,21,0.003838,10,0.224498,4248.155369,0.102855
cleydyr,9,3,12,5,0.001949,11,0.17485599999999998,1899.356513,0.129185
ovictoraurelio,9,10,19,13,0.003469,10,0.189882,15517.455964,0.028072000000000003
tuliohmendes,9,9,18,10,0.0041140000000000005,9,0.230252,10248.515746,0.059164
lipse,8,20,28,0,0.002429,10,0.233191,6511.990572,0.229243
horaciojcfilho,8,15,23,6,0.001948,8,0.247069,10688.219338,0.050236
inacionery,8,12,20,5,0.001036,10,0.2256070000000001,1128.081625,0.14596900000000002
nielsonsantana,8,9,17,0,0.002276,10,0.237127,3506.210783,0.244382
meiralins,8,15,23,0,0.001718,8,0.262201,4314.4472369999985,0.307425
rafaprax,8,12,20,5,0.001059,10,0.223673,733.189037,0.163186
julianalucena,8,1,9,0,0.0017120000000000002,11,0.17463399999999998,69.99360300000001,0.10215
iagobelo,8,12,20,11,0.002808,9,0.252186,11616.028211,0.0818
JoaoGFarias,8,15,23,6,0.001621,8,0.258125,4399.505736,0.066513
tomersimis,8,7,15,6,0.002246,9,0.227197,17132.228180000002,0.080813
lhaisrs,8,2,10,9,0.001854,11,0.188835,2763.398942000001,0.052427
frankjuniorr,8,11,19,10,0.002827,10,0.218675,8363.584905,0.07709400000000001
dvro,8,15,23,0,0.001978,9,0.243339,4111.625189,0.248554
paulorec,8,18,26,5,0.001116,10,0.236513,2959.856233,0.153299
peaonunes,7,20,27,6,0.002026,9,0.2489780000000001,11944.037631,0.027563
leticiamachado,7,7,14,9,0.001359,11,0.214533,586.333333,0.016188
arthurmichel,7,7,14,4,0.002749,10,0.222764,2540.72651,0.115266
deyvisonrocha,7,12,19,4,0.00218,9,0.243123,12331.62243,0.109986
henriquemenezes,7,23,30,0,0.002762,9,0.237641,16062.534704,0.143415
felipefarias,7,4,11,0,0.001227,9,0.2192,16.731335,0.234943
rasoliveira,7,9,16,9,0.003547,10,0.222493,3161.870488,0.103819
pedroqueiroz,7,8,15,5,0.001413,10,0.199636,2222.346285,0.132374
yelken,7,7,14,11,0.002047,10,0.235699,12172.364676,0.038561
rodolfoestevam,7,9,16,11,0.002619,8,0.246403,10417.452421,0.041745
t0rr3sp3dr0,7,6,13,13,0.002937,11,0.17130399999999998,5053.21284,0.01922
acmh,7,4,11,13,0.0019690000000000003,10,0.213812,16743.782119,0.043414
brunolimawd,7,1,8,12,0.006529000000000001,1,1.0,507.0,0.021544
dayvsonlima,7,3,10,14,0.002749,9,0.223036,2672.889431,0.063697
sgosantos,7,1,8,5,0.007923999999999999,12,0.140225,24.471175,0.116196
ThaisaMirely,7,6,13,6,0.002113,9,0.224959,5442.926576,0.020933
eudesll,7,5,12,5,0.0012,10,0.228143,3226.144733,0.119044
pcstl,7,13,20,6,0.002831,7,0.275377,28747.930202,0.14890499999999998
allanragec,7,5,12,5,0.001455,10,0.21703000000000008,2250.966735,0.119806
albertmourato,6,8,14,5,0.0011619999999999998,9,0.235699,1561.348567,0.098951
luizlago,6,6,12,10,0.002127,9,0.228715,3890.0733,0.038817
itsmealves,6,3,9,15,0.002529,10,0.207027,4400.694679,0.032359
fltiago,6,2,8,0,0.001031,10,0.208603,535.824073,0.15596500000000002
dmesquita,6,2,8,6,0.00102,10,0.213979,1163.4261689999996,0.052345
leuthier,6,9,15,24,0.001577,11,0.191274,9196.49073,0.012238
gcaraciolo,6,4,10,10,0.002241,10,0.232696,5115.868004,0.078327
eduardocruz,6,1,7,0,0.0016760000000000002,1,1.0,56.12673,0.307514
lucascmelo,6,4,10,4,0.003122,9,0.228715,2126.648371,0.168211
rvlb-19,6,0,6,13,0.001731,0,0.0,0.0,0.018053
Lucas-CardosoO,6,0,6,13,0.001324,0,0.0,0.0,0.015024
andersonresende,6,0,6,0,0.00085,0,0.0,0.0,0.142439
ramon-v,6,0,6,5,0.000816,0,0.0,0.0,0.122817
rafoli,6,0,6,5,0.001248,0,0.0,0.0,0.07109700000000001
omailson,6,3,9,0,0.002086,9,0.202813,1601.05799,0.193149
paulolieuthier,6,2,8,6,0.002568,10,0.208762,650.189696,0.120042
vanessa,6,14,20,0,0.001174,9,0.221952,6139.02267,0.08532100000000001
TigerRobocop,6,1,7,5,0.001349,11,0.211828,619.129853,0.100108
tancredosouza,5,1,6,13,0.001522,12,0.135242,2206.7308510000007,0.016517
Masterfoni,5,2,7,7,0.003009,12,0.16505999999999998,1674.185317,0.012423
lpmourato,5,4,9,10,0.001797,10,0.20586,1096.508039,0.034414
lubarinobr,5,6,11,21,0.002078,11,0.188446,2611.728561,0.015747
tarruda,5,0,5,10,0.002285,0,0.0,0.0,0.058168
alinedoleron,5,4,9,5,0.002118,10,0.2234,1845.462527,0.106604
favasconcelos,5,4,9,10,0.0016010000000000002,11,0.196557,1422.907502,0.025349
guilhermepaiva,5,9,14,0,0.001235,9,0.22635300000000005,1499.686226,0.04655
hamorim,5,6,11,14,0.00118,9,0.228906,2143.065046,0.072904
AugustoQueiroz,5,9,14,13,0.001551,10,0.18501,3457.332104,0.01369
ericbbraga,5,5,10,10,0.001267,10,0.228906,3659.582595,0.077952
casevictor,5,3,8,0,0.002844,10,0.192754,3780.34281,0.065224
Leviterus,5,7,12,13,0.001481,9,0.214146,7461.645073000002,0.013844
mayrarabelo,5,7,12,9,0.002134,10,0.231419,4960.26817,0.048199
djalmaafilho,5,0,5,14,0.001099,0,0.0,0.0,0.004652
douglaslira,5,1,6,8,0.001399,10,0.187222,442.045751,0.036716000000000006
hnka,5,6,11,15,0.002116,9,0.204936,4703.523639,0.06340499999999999
FranciscoMarinho,5,7,12,10,0.002558,9,0.233191,4583.119794,0.040468
sergiohampel,5,4,9,4,0.002122,10,0.218066,1214.761707,0.118062
mateusrevoredo,5,4,9,10,0.003215,10,0.214649,5459.21865,0.013299
dudurocha,5,0,5,0,0.0016239999999999998,0,0.0,0.0,0.303483
Vitor0liveira,5,6,11,11,0.00191,9,0.215409,6351.125399000001,0.025249
chocoelho,5,10,15,0,0.000893,9,0.227386,1166.782808,0.098944
jonathanslima,5,3,8,12,0.00203,11,0.211094,1665.626043,0.039332
brandizzi,5,0,5,5,0.0008039999999999999,0,0.0,0.0,0.099595
gabrieldluca,5,7,12,13,0.001024,9,0.219992,5563.476871,0.012081
ac-pm,4,0,4,10,0.0007700000000000001,0,0.0,0.0,0.020337
eduardobaia,4,2,6,8,0.001732,11,0.195505,1793.158341,0.027809
wwcoderecife,4,0,4,7,0.000958,0,0.0,0.0,0.053345
eltonrufino,4,5,9,8,0.002413,11,0.219904,4091.580909,0.032617
jrafaelm,4,0,4,0,0.002635,0,0.0,0.0,0.147454
phbraga,4,3,7,13,0.001057,10,0.191608,4074.149961,0.016451
rsarai,4,1,5,0,0.001399,13,0.125114,470.280199,0.024947
matheusmariano,4,0,4,9,0.0015949999999999998,0,0.0,0.0,0.010938
citiufpe,4,0,4,0,0.000704,0,0.0,0.0,0.016584
filipewl,4,6,10,0,0.0031850000000000003,10,0.246736,3933.01309,0.133441
aacgn,4,6,10,6,0.001503,9,0.204249,2096.0,0.01009
andreldm,4,2,6,7,0.005131,1,1.0,733.410943,0.025244
ThiagoAugustoSM,4,3,7,13,0.0013,10,0.180501,823.54881,0.012218
lhew,4,0,4,14,0.001263,0,0.0,0.0,0.009803
igormp,4,5,9,13,0.002395,11,0.156348,2267.047517,0.011989
cassiolpaixao90,4,7,11,5,0.001098,11,0.224131,2278.665848,0.03898
JohnsonMauro,4,6,10,21,0.001575,11,0.223218,3930.878306,0.062822
hugobessa,4,5,9,0,0.000859,9,0.226073,1993.773081,0.123681
corallocatelli,4,6,10,9,0.000884,11,0.214368,4.3333330000000005,0.010549
caionovaes,4,12,16,6,0.000905,9,0.239615,9045.944108,0.025609
guilhermebm,4,1,5,0,0.001578,11,0.174245,434.082672,0.194889
AnnyChien,4,5,9,9,0.000914,11,0.214286,4.8333330000000005,0.012315
renatohlf,4,4,8,15,0.0016120000000000002,10,0.211665,2925.525598,0.031299
caiobsouza,4,2,6,15,0.002046,13,0.128699,2610.553571,0.011664
gppeixoto,4,0,4,6,0.000758,0,0.0,0.0,0.065786
soareswallace,4,0,4,13,0.001274,0,0.0,0.0,0.011626
herbertt,4,0,4,6,0.003005,0,0.0,0.0,0.051229
PedroRossi,4,1,5,6,0.00085,11,0.15603599999999998,611.1464980000002,0.011566
filipe0513,4,4,8,0,0.001402,10,0.215494,11.518504,0.197264
raony,4,1,5,9,0.001391,11,0.18206,700.328655,0.106315
fernandopereira,4,7,11,0,0.001329,10,0.210526,1126.618751,0.082333
setanta,4,0,4,0,0.000705,0,0.0,0.0,0.085155
arineto,4,4,8,0,0.000972,10,0.23015500000000005,1924.297955,0.164434
MiniMarvin,4,0,4,13,0.0016350000000000002,0,0.0,0.0,0.010151
diogobrsantos,4,3,7,4,0.001158,11,0.182606,1537.81537,0.022584
vmms16,4,2,6,24,0.001987,2,0.75,1013.0,0.007162000000000002
tobiasparaiso,4,6,10,5,0.000625,10,0.220523,0.0,0.092468
soikmd2,4,4,8,4,0.00114,10,0.222945,3543.8203020000005,0.067748
paulomenezes,4,6,10,15,0.001349,9,0.223673,8001.905044,0.020705
AbrantesMar,4,6,10,8,0.001849,10,0.211013,4880.042803,0.024267
hfbassani,4,0,4,13,0.000968,0,0.0,0.0,0.011351
brunovpl,4,3,7,5,0.003023,11,0.183646,1722.441508,0.025667
alocjr,3,0,3,16,0.001294,0,0.0,0.0,0.003151
raquelguimaraes,3,1,4,9,0.001189,11,0.18206,88.43287600000002,0.058629
klebercode,3,7,10,0,0.001067,10,0.220701,1059.542098,0.077552
fehaa,3,6,9,8,0.001262,11,0.211175,1978.405059,0.020485
figueredo,3,2,5,0,0.000794,10,0.219376,562.85,0.068302
netoabel,3,0,3,5,0.000901,0,0.0,0.0,0.052309
matheusFTC,3,6,9,12,0.001235,11,0.217288,2738.8629,0.033415
andersongns,3,4,7,12,0.001223,11,0.211094,1050.0,0.033415
DyogoViana,3,1,4,5,0.000913,11,0.20956,0.0,0.036451
ThomasSousa96,3,3,6,7,0.002216,11,0.197477,2012.39682,0.022809
wagnerbeethoven,3,2,5,4,0.000952,2,0.666667,1529.18463,0.007497
MatheusSouza12,3,5,8,24,0.001202,10,0.191207,4512.764123,0.009777
andremelo87,3,4,7,10,0.000938,11,0.198623,732.2642940000003,0.016744
igoriols,3,4,7,5,0.006781999999999999,10,0.194671,5786.490081,0.043156
josealbino,3,1,4,5,0.000852,12,0.140441,23.498134,0.046338
lauromoura,3,9,12,0,0.001,10,0.219112,222.276361,0.108342
alexodrosgomes,3,0,3,17,0.0005740000000000001,0,0.0,0.0,0.017440999999999998
rcaval,3,0,3,9,0.000985,0,0.0,0.0,0.046945
chicofilho,3,2,5,0,0.001101,10,0.211338,1.91337,0.13814300000000002
RodrigoCastiel,3,2,5,13,0.001416,11,0.161747,690.459371,0.010967
juliosmelo,3,1,4,0,0.000816,11,0.194189,264.521941,0.127498
lbrito1,3,3,6,0,0.0026420000000000003,10,0.203264,504.0,0.087297
renatoosousa,3,7,10,13,0.001105,11,0.187158,2804.540526,0.007159
aperrelli,3,5,8,5,0.001286,10,0.17786400000000002,390.195637,0.079068
pereiragislene,3,1,4,9,0.001081,10,0.166414,14.221485,0.087039
Juniorlimaivd,3,13,16,13,0.000989,10,0.198911,7127.467752,0.009209
rafaelgsm,3,2,5,14,0.001196,10,0.184202,1661.0921,0.019339
saulobr88,3,2,5,11,0.001209,11,0.197977,671.969481,0.009905
esdrascosta,3,0,3,12,0.001248,0,0.0,0.0,0.006116
jgfn1,3,3,6,13,0.001439,11,0.16237,255.200079,0.013621
almdac,3,3,6,13,0.001408,11,0.15986,1005.0,0.011143
douglas-queiroz,3,0,3,10,0.0008759999999999999,0,0.0,0.0,0.016789
bebetocf,3,5,8,13,0.000828,11,0.171895,2059.798968,0.00875
tcostam,3,11,14,14,0.000683,10,0.224314,4293.615518,0.01956
daniellqueiroz,3,5,8,3,0.001088,11,0.199128,2599.0,0.024738
Gustavomagalhaes,3,5,8,24,0.00146,11,0.19762,2827.587632,0.006472
penelopearaujo,3,5,8,13,0.001143,9,0.218937,1098.32272,0.008751
guilhermejccavalcanti,3,0,3,6,0.002073,0,0.0,0.0,0.04776
MichaelBarney,3,1,4,13,0.000782,1,1.0,2.0,0.006581999999999999
jpedroh,3,2,5,6,0.001075,10,0.169712,2000.0,0.025064
Allansantosdefreitas,3,2,5,7,0.001084,11,0.22748,1864.520421,0.019794
ronaldoveras,3,3,6,9,0.001655,10,0.229385,1271.755044,0.077141
rmd2,3,2,5,0,0.0008179999999999999,10,0.205706,471.049708,0.165176
felipesotero,3,2,5,0,0.001136,10,0.2256070000000001,0.0,0.2421
isabarros,3,3,6,0,0.000859,10,0.21191,27.433531,0.124323
abriela,3,4,7,9,0.000775,11,0.2142030000000001,1.0,0.010596
walber,3,0,3,5,0.00058,0,0.0,0.0,0.06907100000000001
victorpluna,3,2,5,21,0.000741,10,0.172707,1604.401833,0.067359
mauLeal,3,2,5,11,0.001046,9,0.21142,0.0,0.022582
flpn,3,3,6,15,0.00182,12,0.134743,1050.0,0.005649
gustavomeloGH,3,3,6,15,0.001467,11,0.155505,3636.0,0.006243
pcosv,3,1,4,13,0.000735,10,0.179672,41.95,0.008941
felypenery,3,1,4,7,0.0008410000000000001,11,0.197051,0.0,0.097921
macm3,3,8,11,6,0.0008470000000000001,9,0.221057,1684.987013,0.008551000000000001
antoniocorreia,3,6,9,0,0.001134,10,0.228238,2493.752786,0.100956
manoelcyreno,3,5,8,5,0.0020350000000000004,11,0.201027,612.208844,0.073949
carvalhodj,3,3,6,24,0.002221,1,1.0,12.0,0.005936
adrielcafe,3,1,4,18,0.0015550000000000002,11,0.161652,1096.0,0.009296
lvrma,3,2,5,13,0.001148,10,0.201916,4334.850631,0.011756
danilosoares,3,2,5,0,0.000851,10,0.208762,315.314725,0.06138200000000001
antoniosj,3,3,6,8,0.00222,1,1.0,1046.950292,0.006927
paulobsa,3,1,4,7,0.00265,2,0.666667,39.20404,0.007442
luhanlacerda,3,3,6,11,0.001484,9,0.19949,1050.0,0.012759
lapl,3,3,6,6,0.000828,10,0.203945,553.895238,0.016447
ktquez,3,4,7,11,0.001655,11,0.216944,1141.337923,0.01092
mirjahal,3,7,10,12,0.002049,10,0.182302,3217.724795,0.005425
bernardomelo,3,0,3,13,0.000625,0,0.0,0.0,0.005093
thypad,2,1,3,0,0.000543,10,0.195784,0.0,0.037609
andreneto,2,1,3,13,0.000458,11,0.16596,6040.9467,0.007197
tonnyvx,2,2,4,19,0.001264,2,0.75,0.0,0.003568
pedroboudoux,2,3,5,4,0.001024,2,0.8,16.18463,0.004213000000000001
luanbrito7,2,3,5,13,0.000669,13,0.128378,0.0,0.003568
julihermes,2,5,7,4,0.000672,10,0.202813,1947.865811,0.013655
marcosisocram,2,3,5,4,0.001024,2,0.8,507.0,0.004213000000000001
joseronierison,2,1,3,14,0.001523,10,0.182423,163.278274,0.011319
guilhermebrandao,2,2,4,19,0.001264,2,0.75,0.0,0.003568
leoreinaux,2,0,2,6,0.000699,0,0.0,0.0,0.0035020000000000003
Bonifacio2,2,1,3,9,0.000746,11,0.18206,0.0,0.014002
rafaelmotaalves,2,3,5,13,0.000669,13,0.128378,0.0,0.003568
guinetik,2,1,3,21,0.000544,1,1.0,505.0,0.011555
dgmneto,2,1,3,6,0.000505,10,0.199418,0.0,0.007949
rhnasc,2,0,2,0,0.000517,0,0.0,0.0,0.019827
rlom,2,1,3,13,0.001034,13,0.136285,0.0,0.004288
zimmerle,2,1,3,0,0.000535,11,0.189161,49.436147,0.036157
WilbertoFilho,2,0,2,14,0.000662,0,0.0,0.0,0.004322
caiocaladoo,2,0,2,13,0.000752,0,0.0,0.0,0.003181
oliveriojnn,2,1,3,11,0.0008990000000000002,12,0.178327,235.479654,0.029552
ThomazFB,2,2,4,10,0.001312,10,0.193162,272.077778,0.008097
alnp,2,3,5,0,0.00043,10,0.181879,0.0,0.012602
daniloBlera,2,0,2,24,0.001107,0,0.0,0.0,0.005896
AlexandreDiegoS,2,2,4,5,0.001373,11,0.166667,1192.299225,0.016644
lucasbarross,2,4,6,13,0.000709,12,0.147169,1096.0,0.003568
hpbl,2,2,4,6,0.000625,8,0.223856,0.0,0.023445
tiagotrigo,2,0,2,14,0.000489,0,0.0,0.0,0.0032310000000000004
neryluc,2,1,3,12,0.000753,11,0.15423599999999998,1172.007741,0.007047
erickapsilva,2,0,2,10,0.000691,0,0.0,0.0,0.002993
rpragana,2,0,2,5,0.001082,0,0.0,0.0,0.078098
wfsneto,2,0,2,4,0.000598,0,0.0,0.0,0.014872
mulatinho,2,1,3,7,0.002789,2,0.666667,2.0,0.005225
lpmfilho,2,0,2,9,0.001085,0,0.0,0.0,0.055488
brunosouza,2,1,3,14,0.000787,1,1.0,465.704762,0.046224
AdeildoNeto,2,0,2,7,0.000743,0,0.0,0.0,0.004283
gillianomenezes,2,1,3,7,0.0010960000000000002,11,0.174578,8.14697,0.011504
rcaferraz,2,0,2,0,0.0005809999999999999,0,0.0,0.0,0.02409
fabiorush,2,0,2,17,0.000562,0,0.0,0.0,0.001861
nivan,2,0,2,6,0.000592,0,0.0,0.0,0.018919
PauloSanches,2,0,2,5,0.000543,0,0.0,0.0,0.012487
assj,2,2,4,5,0.002102,12,0.142969,609.7519639999998,0.007024
cinguilherme,2,0,2,0,0.0008960000000000002,0,0.0,0.0,0.086635
fjmartins,2,3,5,15,0.000936,10,0.183585,5172.0,0.006329
UdneyCarvalho,2,2,4,24,0.001803,2,0.75,0.0,0.004907
abhnerAraujo,2,1,3,5,0.002383,1,1.0,505.0,0.018003
diogoffmelo,2,1,3,22,0.001172,2,0.666667,2.0,0.002269
pabloreis,2,0,2,21,0.000725,0,0.0,0.0,0.002632
GabrielGouv,2,2,4,6,0.000999,10,0.169712,0.0,0.006981
saulolso,2,0,2,4,0.000684,0,0.0,0.0,0.045849
linhaplana,2,0,2,4,0.000947,0,0.0,0.0,0.005764
andresmachado,2,0,2,0,0.000685,0,0.0,0.0,0.011184
AlexSoaresDeSiqueira,2,3,5,10,0.000784,11,0.14747000000000002,562.401833,0.008064
fms6,2,2,4,13,0.001342,12,0.157743,547.0,0.004288
aquelefelipe,2,0,2,0,0.00043,0,0.0,0.0,0.012602
Daanielvb,2,0,2,33,0.000749,0,0.0,0.0,0.001861
gabrielteodosio,2,3,5,15,0.001261,12,0.134743,504.0,0.004551
pricardoti,2,0,2,20,0.000749,0,0.0,0.0,0.001861
ricardowendell,2,0,2,9,0.000816,0,0.0,0.0,0.028956
andredm,2,0,2,0,0.000685,0,0.0,0.0,0.10886400000000004
izaiasavila,2,4,6,10,0.000585,11,0.194464,778.382845,0.003867
joelnetodev,2,2,4,21,0.0008470000000000001,12,0.18285,0.0,0.012028
williambeto,2,1,3,12,0.000692,11,0.15423599999999998,905.717054,0.004825
WilliamRoger,2,2,4,4,0.0019920000000000003,10,0.186331,1050.0,0.01819
feliperp-81,2,0,2,5,0.000677,0,0.0,0.0,0.040239
thiagoprazeres,2,2,4,24,0.000726,12,0.160704,569.252941,0.005963
wtmf,2,0,2,5,0.00045,0,0.0,0.0,0.039799
eduardo-melo,2,0,2,8,0.001306,0,0.0,0.0,0.017533
alvarocavalcanti,2,0,2,9,0.000816,0,0.0,0.0,0.028956
lucianowolf,2,0,2,0,0.0005269999999999999,0,0.0,0.0,0.032247000000000005
davincif,2,0,2,2,0.0007019999999999999,0,0.0,0.0,0.001861
thiagoolsilva,2,1,3,10,0.000858,10,0.189161,0.0,0.016689
wallacethierre,2,1,3,10,0.000858,10,0.189161,0.0,0.016689
tonidas,2,0,2,6,0.001134,0,0.0,0.0,0.016799
iagoneresb,2,3,5,24,0.001172,3,0.5,8.0,0.00269
consensotec,2,0,2,7,0.000679,0,0.0,0.0,0.001861
marcocarnut,2,0,2,0,0.000535,0,0.0,0.0,0.036157
adilsonchacon,2,0,2,9,0.000502,0,0.0,0.0,0.023327
dennys-bd,2,0,2,14,0.000679,0,0.0,0.0,0.001861
jonathantsilva,2,0,2,4,0.000633,0,0.0,0.0,0.017526
prximenes,2,3,5,13,0.000883,11,0.15625899999999998,0.0,0.006836
PunishedBois,2,2,4,13,0.000883,11,0.15621400000000002,0.0,0.006836
felipedemacedo,2,2,4,0,0.000733,10,0.197051,659.917328,0.011398
Matheus-Campos,2,0,2,24,0.000683,0,0.0,0.0,0.006333
jfabiofl,2,0,2,4,0.00074,0,0.0,0.0,0.005195
rbrazileiro,2,0,2,10,0.000641,0,0.0,0.0,0.011635
LGR3,2,3,5,13,0.000633,10,0.183462,1952.019199,0.0054340000000000005
fchicout,2,2,4,10,0.0017059999999999998,11,0.17688800000000002,2145.0,0.005093
viniciusmsfraga,2,0,2,1,0.000627,0,0.0,0.0,0.00222
mabj,2,0,2,3,0.000733,0,0.0,0.0,0.005203
ntocampos,2,2,4,13,0.000996,10,0.201916,1293.278116,0.032836000000000004
sudorafa,2,1,3,10,0.000816,12,0.150535,1098.0,0.0025800000000000003
rennanmoura1990,2,3,5,19,0.001404,1,1.0,2.0,0.003568
kessiacastro,2,2,4,9,0.001223,11,0.21191,0.0,0.034822000000000006
dmente03,2,9,11,0,0.000737,10,0.238988,1069.121342,0.012518
luizpaulogodoy,2,8,10,14,0.00049,10,0.207262,1638.155244,0.004754
jcrbsa,2,1,3,9,0.0008119999999999999,11,0.197051,316.08586,0.02057
ledebour,2,3,5,5,0.000986,12,0.140665,1099.0,0.002269
adailsonfilho,2,2,4,0,0.000539,10,0.208444,554.6474929999998,0.007042000000000001
giuliosa,2,2,4,9,0.001172,11,0.212074,18.803068,0.03879
magalhaesrebecca,2,1,3,9,0.0006,11,0.212051,0.0,0.006573000000000001
fecalemos,2,3,5,12,0.004081,9,0.220346,3104.509766,0.011401
raisagalindo,2,4,6,9,0.00061,11,0.2142030000000001,0.0,0.006296
tecavasconcelos,2,5,7,9,0.0006190000000000001,11,0.214286,3.0,0.0073170000000000015
tpmarcs,2,3,5,14,0.000878,9,0.223948,162.299432,0.014032
daicorrea,2,2,4,9,0.001223,11,0.21191,0.0,0.034822000000000006
SandroSena,2,2,4,8,0.001022,11,0.200073,539.006926,0.014658
leonardooo,2,2,4,9,0.000773,11,0.215663,1201.84215,0.031293
guuhh,2,2,4,14,0.000977,11,0.194326,651.0424059999998,0.014143
valterh4ck3r,2,4,6,7,0.001291,11,0.197549,822.558725,0.020039
BernardoHazin,2,1,3,5,0.000717,10,0.205013,548.0,0.020961
MauricioLimaJR,2,2,4,15,0.001154,10,0.20509,0.0,0.025431
joaopaulosama,2,11,13,7,0.000918,10,0.233191,8794.258026000001,0.00775
victorfsf,2,2,4,0,0.000519,10,0.219815,248.403372,0.061677
pernambucano,2,2,4,0,0.000579,10,0.219727,613.521419,0.059478
tuliocpbs,2,1,3,0,0.000519,10,0.219112,0.0,0.061677
sfilhu,2,8,10,21,0.000754,9,0.208207,4042.4097090000014,0.06568099999999999
fraposo,2,1,3,4,0.000786,10,0.203945,0.0,0.056217
thaisabr,2,2,4,6,0.001827,11,0.155859,4.369048,0.040134
rbm4,2,4,6,13,0.000584,10,0.195296,1572.300565,0.003741
geocarvalho,2,4,6,0,0.000618,11,0.195924,503.5,0.004819
ivanAndrade,2,4,6,4,0.000786,10,0.21772,504.0,0.056217
Augusto94,2,2,4,6,0.000671,1,1.0,506.583333,0.004485
marcoshmendes,2,6,8,4,0.000788,10,0.224867,687.505542,0.01405
viniciusgalvao,2,4,6,4,0.0007019999999999999,10,0.225793,524.945376,0.046545
paulinhoerry,2,3,5,4,0.001044,10,0.21746,516.606659,0.050317
wbgalvao,2,3,5,0,0.000676,11,0.195854,1004.0,0.024858
ramonsantos,2,6,8,8,0.001159,11,0.214314,2558.25,0.006498
mauriciomanoel,2,2,4,9,0.001201,10,0.180085,113.576136,0.035146
filipeluiz,2,2,4,12,0.002038,10,0.183339,269.47879,0.017518000000000002
amandasavluchinske,2,15,17,0,0.000522,9,0.222042,775.0,0.012602
mangueBit,2,9,11,13,0.000797,9,0.237332,1750.31424,0.003151
heitorpaceli,2,4,6,5,0.000731,9,0.228238,124.020907,0.039373000000000005
jctvEC,2,3,5,13,0.001328,11,0.15986,1050.0,0.004265
carlosvictor,2,4,6,10,0.000842,10,0.197905,2208.099416,0.010529
gilesv,2,4,6,6,0.000688,9,0.204097,0.0,0.004841
matheuslins,2,8,10,0,0.0007570000000000001,10,0.23064,1536.483297,0.021868
eduardosm7,2,4,6,6,0.000688,9,0.204097,0.0,0.004841
andersonberg,2,2,4,7,0.001638,10,0.21142,1003.100643,0.094856
wellington16,2,6,8,0,0.0008619999999999999,10,0.225329,3764.229705,0.004985
foolOnTheHill,2,4,6,6,0.000504,9,0.222132,37.756746,0.011955
victoracioli,2,2,4,0,0.000833,10,0.211338,0.0,0.148134
filipecabraal,1,1,2,21,0.000609,12,0.155367,550.0,0.00093
lsca,1,0,1,13,0.000426,0,0.0,0.0,0.00157
saulo2,1,0,1,12,0.0005780000000000001,0,0.0,0.0,0.00219
tavlima,1,0,1,0,0.00043,0,0.0,0.0,0.036288
eron93br,1,1,2,7,0.000611,2,0.666667,1010.0,0.002729
glpibr,1,0,1,-2,0.000609,0,0.0,0.0,0.00093
miguel89,1,0,1,6,0.000376,0,0.0,0.0,0.00093
felipemanga,1,0,1,21,0.001145,0,0.0,0.0,0.012813
joaozig,1,0,1,14,0.000382,0,0.0,0.0,0.003392
allandoamaral,1,0,1,15,0.000469,0,0.0,0.0,0.00093
raafaelima,1,1,2,5,0.000609,13,0.123346,0.0,0.0016
joelcipriano,1,0,1,6,0.000393,0,0.0,0.0,0.004511
jpaulorio,1,0,1,9,0.000481,0,0.0,0.0,0.017694
alisonamerico,1,0,1,24,0.000534,0,0.0,0.0,0.002724
misawsneto,1,0,1,-3,0.000734,0,0.0,0.0,0.00129
brunosan7os,1,1,2,0,0.000451,11,0.183954,0.0,0.001975
monteiro-luiz,1,0,1,13,0.000745,0,0.0,0.0,0.004654999999999999
hfcamilo,1,0,1,4,0.0006190000000000001,0,0.0,0.0,0.001859
rnns,1,0,1,0,0.00043,0,0.0,0.0,0.036288
dpm-cin,1,0,1,1,0.000487,0,0.0,0.0,0.00129
jonathan-silva,1,0,1,7,0.000663,0,0.0,0.0,0.016134
MayaraCastro,1,1,2,-2,0.002193,1,1.0,0.0,0.00129
Thyerry,1,1,2,-2,0.002193,1,1.0,0.0,0.00129
cassianoricardo,1,0,1,8,0.000493,0,0.0,0.0,0.002043
diogo-lins,1,0,1,5,0.00043,0,0.0,0.0,0.026867
rafarocha,1,0,1,-3,0.000469,0,0.0,0.0,0.00093
danielmedeiros52,1,0,1,5,0.000382,0,0.0,0.0,0.01656
raphaelmonte,1,1,2,-3,0.000609,1,1.0,1.0,0.00093
fabiorecife,1,0,1,15,0.000594,0,0.0,0.0,0.002088
akshaykarle,1,0,1,9,0.000481,0,0.0,0.0,0.017694
aeciovc,1,0,1,20,0.000469,0,0.0,0.0,0.00093
wagnerpaxs,1,2,3,-3,0.000953,1,1.0,1.0,0.00129
ianfireman,1,1,2,5,0.002355,1,1.0,0.0,0.002993
igor-simoes,1,0,1,-2,0.000609,0,0.0,0.0,0.00093
leleofg,1,0,1,-3,0.0008470000000000001,0,0.0,0.0,0.001235
Artrogeno,1,0,1,-2,0.000609,0,0.0,0.0,0.00093
rodrigojulianib,1,1,2,-3,0.000734,2,0.666667,0.0,0.00129
KewinLima,1,2,3,-3,0.000953,1,1.0,1.0,0.00129
medeirosrod,1,3,4,14,0.0005480000000000001,2,0.8,1080.193589,0.010704
niltonheck,1,0,1,18,0.000469,0,0.0,0.0,0.00093
danielfsbarreto,1,0,1,9,0.000481,0,0.0,0.0,0.017694
MarcusDEFGH,1,0,1,0,0.00041,0,0.0,0.0,0.003129
geraldo7junior,1,0,1,24,0.000638,0,0.0,0.0,0.002108
gildoneto,1,1,2,4,0.001176,11,0.15711,0.0,0.002925
elidioxg,1,1,2,6,0.000556,10,0.178224,0.0,0.00129
phellipealexandre,1,0,1,-2,0.000609,0,0.0,0.0,0.00093
tmoura10,1,0,1,5,0.000397,0,0.0,0.0,0.023239
EduardoFreit,1,1,2,13,0.000705,12,0.13786199999999998,0.0,0.001846
palmeidaprog,1,0,1,-2,0.000609,0,0.0,0.0,0.00093
pianolab,1,0,1,21,0.000445,0,0.0,0.0,0.0017010000000000007
marvinbraga,1,0,1,6,0.00044,0,0.0,0.0,0.007444
thiagohenrique0810,1,0,1,-2,0.000609,0,0.0,0.0,0.00093
gugacarvalho,1,0,1,-2,0.000609,0,0.0,0.0,0.00093
eduardoluiz7,1,1,2,5,0.000734,11,0.160631,0.0,0.00129
engtom,1,1,2,-3,0.000734,2,0.666667,0.0,0.00129
klaytoncavalcante,1,1,2,7,0.0004,11,0.189161,0.0,0.002217
pethersilva,1,0,1,10,0.000718,0,0.0,0.0,0.008745000000000001
cleniomendes,1,2,3,0,0.000573,11,0.165215,115.821729,0.00129
debscorreia,1,0,1,0,0.0006490000000000001,0,0.0,0.0,0.091049
vitordeatorreao,1,2,3,22,0.001326,1,1.0,2.0,0.0016
estevaocm,1,0,1,9,0.000399,0,0.0,0.0,0.0016190000000000002
ianlucas,1,1,2,11,0.000556,11,0.17263,0.0,0.00129
wylliams,1,0,1,5,0.000462,0,0.0,0.0,0.005738
jefferson-lima,1,0,1,8,0.000493,0,0.0,0.0,0.002043
filipecalegario,1,0,1,10,0.0005480000000000001,0,0.0,0.0,0.010704
diegocarloslima,1,0,1,0,0.000431,0,0.0,0.0,0.01445
mariojor,1,0,1,9,0.0007030000000000001,0,0.0,0.0,0.029673
sjcostaneto,1,1,2,8,0.000493,12,0.176546,0.0,0.002043
marcelogalvao,1,0,1,21,0.000422,0,0.0,0.0,0.00093
ess2,1,1,2,13,0.000404,10,0.191877,0.0,0.0017239999999999998
brunolrb,1,0,1,7,0.000399,0,0.0,0.0,0.00093
rafaelroballo,1,0,1,15,0.0005200000000000001,0,0.0,0.0,0.004017
batebit,1,0,1,5,0.000422,0,0.0,0.0,0.00093
wlcosta,1,0,1,9,0.000588,0,0.0,0.0,0.007229000000000002
marcomachado,1,0,1,-3,0.000469,0,0.0,0.0,0.00093
svaf2,1,0,1,13,0.000426,0,0.0,0.0,0.00157
jean-rar,1,0,1,15,0.000686,0,0.0,0.0,0.001916
RobsonPereira13,1,0,1,19,0.000727,0,0.0,0.0,0.001784
wesleygcs,1,0,1,-2,0.000609,0,0.0,0.0,0.00093
ericlrf,1,0,1,-2,0.000609,0,0.0,0.0,0.00093
manoelamorimneto,1,0,1,5,0.000404,0,0.0,0.0,0.025802
JNMarcos,1,0,1,-2,0.000609,0,0.0,0.0,0.00093
romagueralima,1,0,1,-2,0.000609,0,0.0,0.0,0.00093
jessica-rmo,1,0,1,6,0.00037,0,0.0,0.0,0.001714
axontec,1,0,1,0,0.00049,0,0.0,0.0,0.041845
mgrb,1,0,1,24,0.0005769999999999999,0,0.0,0.0,0.002353
sabrinandrade,1,0,1,5,0.000382,0,0.0,0.0,0.01656
Rafaziz,1,1,2,-2,0.002193,1,1.0,0.0,0.00129
madytorres,1,0,1,4,0.0006320000000000001,0,0.0,0.0,0.04398
tecnologiane10,1,0,1,-2,0.000609,0,0.0,0.0,0.00093
reueljonathan,1,0,1,6,0.00044,0,0.0,0.0,0.007444
denissonsantos,1,0,1,4,0.000496,0,0.0,0.0,0.006141
leimig,1,1,2,6,0.000392,1,1.0,2.0,0.00129
carloseachaves,1,1,2,6,0.000392,10,0.204293,0.0,0.00129
matheusqfs,1,1,2,28,0.000556,2,0.6,0.0,0.00129
antonioaurel,1,0,1,5,0.000469,0,0.0,0.0,0.00093
alejoceballos,1,0,1,6,0.000662,0,0.0,0.0,0.00129
flavioms7,1,0,1,-2,0.000609,0,0.0,0.0,0.00093
rodrigoal,1,0,1,15,0.001199,0,0.0,0.0,0.003039
rfapo,1,0,1,12,0.000385,0,0.0,0.0,0.00093
danielAtOgilvy,1,0,1,21,0.000409,0,0.0,0.0,0.006749
PedroRafaelDinizMarinho,1,0,1,-2,0.000609,0,0.0,0.0,0.00093
guilhermegomes01,1,1,2,4,0.000412,11,0.16845,0.0,0.00129
wilberto-blaze,1,0,1,14,0.000382,0,0.0,0.0,0.003392
feliperod,1,0,1,0,0.000439,0,0.0,0.0,0.058547
andreleitao,1,0,1,6,0.000499,0,0.0,0.0,0.017988999999999998
mmfsf,1,1,2,-2,0.002193,1,1.0,0.0,0.00129
vitorbc,1,1,2,-2,0.002193,1,1.0,0.0,0.00129
lericardolima,1,1,2,-2,0.002193,1,1.0,0.0,0.00129
rfccg,1,0,1,6,0.00041500000000000017,0,0.0,0.0,0.005378
douglascas,1,1,2,-2,0.002193,1,1.0,0.0,0.00129
joaosantana,1,0,1,0,0.000681,0,0.0,0.0,0.063614
tiagofsilva,1,0,1,0,0.001078,0,0.0,0.0,0.008705
dolalima,1,0,1,10,0.0010539999999999998,0,0.0,0.0,0.00198
gdanzi,1,0,1,22,0.000893,0,0.0,0.0,0.001339
hugonmelo,1,0,1,0,0.0004940000000000001,0,0.0,0.0,0.002549
felipebelucena,1,0,1,10,0.0005480000000000001,0,0.0,0.0,0.010704
iatj,1,0,1,-2,0.000609,0,0.0,0.0,0.00093
italolemos,1,0,1,33,0.000469,0,0.0,0.0,0.00093
rodrigomuribec,1,0,1,0,0.000387,0,0.0,0.0,0.015580000000000004
filipecmedeiros,1,0,1,-3,0.0008470000000000001,0,0.0,0.0,0.001235
gustavolopess,1,1,2,-3,0.000609,1,1.0,1.0,0.00093
mayarajuvencio,1,1,2,-2,0.002193,1,1.0,0.0,0.00129
hugosteixeira,1,0,1,24,0.000478,0,0.0,0.0,0.00361
sergio3010,1,0,1,0,0.000681,0,0.0,0.0,0.063614
BAMoreira,1,0,1,-2,0.000609,0,0.0,0.0,0.00093
andalvalmeida,1,0,1,13,0.000487,0,0.0,0.0,0.00129
fabiolindemberg,1,0,1,9,0.000422,0,0.0,0.0,0.00093
Uirado,1,1,2,16,0.000734,2,0.666667,0.0,0.00129
tulliusvinicius,1,0,1,4,0.000571,0,0.0,0.0,0.007767
VictorMouraz,1,1,2,15,0.000734,12,0.146823,0.0,0.00129
caiosm1005,1,1,2,-2,0.002193,1,1.0,0.0,0.00129
thiagogalvao,1,1,2,-2,0.002193,1,1.0,0.0,0.00129
Andre-dam,1,0,1,13,0.000463,0,0.0,0.0,0.002418
davidrft,1,1,2,7,0.000848,1,1.0,506.0,0.001406
betegelse,1,0,1,7,0.00105,0,0.0,0.0,0.001298
diegoferreirati,1,1,2,24,0.000661,4,0.35,0.0,0.001661
borgiani,1,0,1,17,0.000422,0,0.0,0.0,0.00093
sunr00t,1,0,1,24,0.000661,0,0.0,0.0,0.001661
ericksantana,1,0,1,10,0.000422,0,0.0,0.0,0.00093
anderssonmelo,1,0,1,0,0.000422,0,0.0,0.0,0.00093
lucasrbk,1,1,2,-2,0.002193,1,1.0,0.0,0.00129
LucasFranciscoCorreia,1,1,2,-2,0.002193,1,1.0,0.0,0.00129
diegotsouza83,1,0,1,11,0.000528,0,0.0,0.0,0.011304
petrusaugusto,1,0,1,28,0.000556,0,0.0,0.0,0.00129
ricardovasc,1,0,1,-2,0.000609,0,0.0,0.0,0.00093
igoleo,1,0,1,0,0.00092,0,0.0,0.0,0.018044
vandialves,1,1,2,-2,0.002193,1,1.0,0.0,0.00129
JPMagalhaes,1,1,2,12,0.000734,12,0.133075,0.0,0.00129
modcs,1,1,2,-2,0.002193,1,1.0,0.0,0.00129
filipe-torres,1,0,1,14,0.000484,0,0.0,0.0,0.0022440000000000003
wsantanapitang,1,0,1,-2,0.000609,0,0.0,0.0,0.00093
jeffrs,1,0,1,-2,0.000609,0,0.0,0.0,0.00093
LucasNevesV,1,1,2,-2,0.002193,1,1.0,0.0,0.00129
mfeitosa,1,0,1,9,0.000481,0,0.0,0.0,0.017694
jbjj,1,0,1,15,0.000469,0,0.0,0.0,0.00093
dcaragao,1,1,2,6,0.000421,12,0.16131900000000002,503.0,0.008884
emesonsantana,1,0,1,14,0.000382,0,0.0,0.0,0.003392
jpfreire,1,0,1,-2,0.000609,0,0.0,0.0,0.00093
slunart,1,0,1,10,0.000422,0,0.0,0.0,0.00093
hforesti,1,0,1,14,0.000484,0,0.0,0.0,0.0022440000000000003
ericmilfont,1,0,1,21,0.000791,0,0.0,0.0,0.00231
UmbertoB,1,1,2,-2,0.002193,1,1.0,0.0,0.00129
CaioMalaquias,1,0,1,9,0.000539,0,0.0,0.0,0.001692
julioamorim,1,1,2,-2,0.002193,1,1.0,0.0,0.00129
Kassio-Ferreira,1,0,1,6,0.000422,0,0.0,0.0,0.00093
84PC04,1,1,2,-2,0.002193,1,1.0,0.0,0.00129
AleffSouza,1,0,1,15,0.000672,0,0.0,0.0,0.0049310000000000005
brunofalc,1,0,1,28,0.000556,0,0.0,0.0,0.00129
atailton,1,3,4,28,0.000802,1,1.0,2.0,0.00129
BonnerAthos,1,0,1,7,0.0004,0,0.0,0.0,0.002217
Renartes,1,1,2,13,0.000487,10,0.16702,0.0,0.00129
acmd,1,1,2,1,0.000487,11,0.171322,0.0,0.00129
kepa,1,0,1,15,0.000629,0,0.0,0.0,0.007514
joelbarbosamoraes,1,0,1,2,0.000422,0,0.0,0.0,0.00093
walterjardim,1,0,1,14,0.000399,0,0.0,0.0,0.00093
joycelima,1,0,1,0,0.000439,0,0.0,0.0,0.058547
wba25,1,2,3,5,0.000953,10,0.191304,549.0,0.00129
marconemm,1,2,3,10,0.000573,13,0.131253,0.0,0.00129
ArthurLCastro,1,2,3,7,0.000663,11,0.197477,1512.0,0.016134
IsmaelGomes,1,2,3,10,0.000573,13,0.131253,0.0,0.00129
roMendes,1,1,2,9,0.000481,11,0.178676,0.0,0.017694
rubens73,1,2,3,10,0.00063,10,0.193982,0.0,0.006242
aht360,1,2,3,13,0.000624,11,0.17844400000000002,0.0,0.006063000000000001
Valgueiro,1,1,2,13,0.000624,11,0.159627,0.0,0.006063000000000001
zecafeitosa,1,1,2,21,0.0008470000000000001,11,0.183612,1098.0,0.001235
pnasc,1,2,3,13,0.000624,11,0.153158,533.321429,0.006063000000000001
eduardascharnhorst,1,2,3,15,0.000629,10,0.170239,1.5,0.007514
sccrn,1,2,3,15,0.000629,10,0.170239,1.5,0.007514
FranclinC,1,1,2,6,0.000469,1,1.0,1.0,0.00093
viniciusmantero,1,1,2,8,0.000697,12,0.191207,0.0,0.013213
felipeisidorio,1,1,2,8,0.000697,12,0.191207,0.0,0.013213
johanngomes,1,5,6,9,0.000481,10,0.199708,604.137343,0.017694
manunejaim,1,1,2,6,0.000499,9,0.219815,0.0,0.017988999999999998
jhdavino,1,5,6,10,0.000454,10,0.19812,154.048889,0.001784
lmmenge,1,1,2,0,0.006149,11,0.149686,0.0,0.047189
wsena,1,1,2,7,0.000663,11,0.197051,0.0,0.016134
andredidier,1,1,2,7,0.000663,11,0.197051,0.0,0.016134
wagnerbit,1,1,2,7,0.000663,11,0.197051,0.0,0.016134
rodrigoperazzo,1,2,3,12,0.000953,11,0.15346,549.0,0.00129
tvarjao,1,1,2,0,0.000582,10,0.192011,0.0,0.019002
diogoan,1,2,3,0,0.000387,10,0.208207,504.0,0.015580000000000004
draraujoo,1,1,2,11,0.0005780000000000001,11,0.190808,0.0,0.006357
fdsadat,1,1,2,0,0.00092,10,0.168667,0.0,0.018044
eduardolsneto2,1,2,3,0,0.000359,10,0.181818,0.0,0.002568
felipemarques8,1,1,2,4,0.000663,11,0.182241,0.0,0.01263
brunodutra,1,1,2,12,0.005882,1,1.0,0.0,0.004557
llac78,1,1,2,5,0.0005769999999999999,11,0.178385,0.0,0.013372
renatoalvesdev,1,2,3,4,0.000443,10,0.196486,0.0,0.002635
douglasrangel,1,7,8,4,0.000679,10,0.202499,550.0,0.00129
claudvanbarret,1,1,2,11,0.0005769999999999999,9,0.197763,0.0,0.006573000000000001
paulofloliveira,1,2,3,9,0.0004940000000000001,12,0.176806,7.0,0.0043
MaryCaroline,1,1,2,11,0.000528,10,0.201471,0.0,0.011304
gan640,1,1,2,13,0.000745,12,0.146289,0.0,0.004654999999999999
adecarli,1,2,3,13,0.000745,11,0.16960699999999998,0.0,0.004654999999999999
AleffHenrique,1,1,2,6,0.00044,9,0.198192,0.0,0.007444
felipebagetti,1,1,2,6,0.00044,9,0.198192,0.0,0.007444
rafaelllins,1,1,2,0,0.000432,11,0.189161,0.0,0.021708
lmyboy,1,1,2,11,0.000528,11,0.179731,72.435573,0.011304
ebl4,1,1,2,6,0.00044,9,0.205397,6.445238,0.007444
diogocaetano,1,1,2,6,0.000687,11,0.192011,547.0,0.002055
andersonpe,1,2,3,7,0.000663,11,0.208762,0.0,0.016134
IFormiga,1,3,4,10,0.000438,10,0.216772,982.909596,0.020030000000000003
albjoaov,1,2,3,15,0.000953,11,0.172036,549.0,0.00129
pedrojsn96,1,2,3,6,0.000614,1,1.0,0.0,0.001808
jamissonfreitas,1,4,5,0,0.000461,10,0.224039,92.767647,0.001837
thiagoarrais,1,8,9,9,0.0006580000000000001,11,0.20932,684.462589,0.0048200000000000005
GeneseLessa,1,2,3,0,0.000491,11,0.17413399999999998,0.0,0.008431000000000001
rsilvabr,1,2,3,0,0.000575,10,0.208682,0.0,0.050316
joaoluizdhv,1,4,5,1,0.000743,10,0.206664,551.0,0.00129
hugoesb,1,4,5,0,0.0006259999999999999,10,0.20956,0.696429,0.062202
marcelolima,1,2,3,0,0.00043,10,0.213729,0.0,0.036288
alicexmelo,1,1,2,9,0.0007030000000000001,11,0.211828,0.0,0.029673
witerbino,1,5,6,21,0.000624,10,0.223856,783.5264070000003,0.003609
mikeliguedes,1,1,2,9,0.0004940000000000001,11,0.212051,0.0,0.0043
grodrigues,1,11,12,5,0.000547,9,0.261201,2782.571479,0.026935
alexjosesilva,1,4,5,9,0.0007030000000000001,11,0.215918,1007.503003,0.029673
claudiopacheco,1,2,3,13,0.000453,9,0.213313,0.0,0.003418
itamarsilva,1,1,2,6,0.00037,9,0.202663,0.0,0.001714
esdrascavalcs,1,13,14,6,0.000629,9,0.261575,3341.022025,0.004653
dayvisons,1,3,4,6,0.00037,9,0.203113,6.142857,0.001714
rafaelfvcs,1,3,4,6,0.000802,9,0.216791,549.0,0.00129
luishmelo,1,3,4,6,0.00041500000000000017,9,0.222674,13.0,0.005378
rcbop,1,9,10,6,0.000662,9,0.256625,551.0,0.00129
viniciuspolux,1,2,3,8,0.000763,10,0.215155,184.854797,0.002885
lucianojsjr,1,3,4,4,0.000441,10,0.216772,5.3869050000000005,0.00266
agcloud,1,1,2,4,0.000625,10,0.213147,0.0,0.005863
patomarques,1,3,4,14,0.00037,11,0.224223,239.231932,0.001714
wison27,1,2,3,13,0.000745,12,0.146368,10.416667,0.004654999999999999
flaubert165,1,1,2,5,0.000404,10,0.210931,0.0,0.025802
Gabisampaio,1,2,3,6,0.001347,10,0.184388,0.0,0.020579
fmm,1,1,2,6,0.00041500000000000017,10,0.166363,13.9,0.005378
mafrnds,1,2,3,5,0.000547,11,0.20964,0.0,0.026935
yeltsinseal,1,1,2,5,0.000547,11,0.20956,0.0,0.026935
maysaborges,1,1,2,5,0.000547,11,0.20956,0.0,0.026935
ericklucena,1,1,2,5,0.000547,11,0.20956,0.0,0.026935
FilipelIOn,1,3,4,0,0.000478,11,0.204249,226.923988,0.00361
lucasbiagini,1,4,5,13,0.000743,9,0.200437,550.0,0.00129
levisaturnino,1,1,2,8,0.000493,10,0.180085,35.279459,0.002043
thiagotargino,1,4,5,21,0.0006320000000000001,10,0.211583,1016.151001,0.04398
matequeiroz,1,3,4,11,0.000802,10,0.20857,549.0,0.00129
adozrocha,1,1,2,0,0.000575,10,0.208444,0.0,0.050316
matheusmmx,1,1,2,0,0.000575,10,0.208444,0.0,0.050316
arthurms,1,1,2,9,0.000411,10,0.208682,79.18868,0.002741
deividazevedo2,1,8,9,0,0.00045,10,0.25524,832.4421629999997,0.036095
FernandaLandim,1,1,2,5,0.0009789999999999998,9,0.199273,0.0,0.05639
paulapithon,1,1,2,15,0.000839,11,0.171949,2191.553571,0.001508
dnloliveira1,1,0,1,-3,0.000734,0,0.0,0.0,0.00129
brunapvasconcelos,1,1,2,24,0.000478,12,0.16061,0.0,0.00361
manoelfneto,1,1,2,24,0.000534,11,0.160563,0.0,0.002724
romildojuliano,1,2,3,13,0.000509,10,0.17649,0.0,0.003634000000000001
marlosin,1,1,2,10,0.001012,11,0.176774,0.0,0.003443
deyvisonbm,1,1,2,10,0.000508,11,0.17706,109.298898,0.002512
feliciosan,1,1,2,12,0.000904,12,0.17435599999999998,0.0,0.005867
jmignac,1,3,4,14,0.000381,11,0.17184100000000002,0.0,0.001869
staylward,1,1,2,5,0.001186,12,0.155197,0.0,0.004155
pablostellet,1,1,2,9,0.000479,1,1.0,69.128858,0.004436
andrebuarque,1,2,3,0,0.000573,12,0.152186,2.904401,0.00129
deyvisonrochaidealizza,1,1,2,4,0.000412,12,0.154648,0.0,0.00129
keywilliams,1,1,2,8,0.000591,11,0.1743,0.0,0.004077
vinyfalcao,1,1,2,8,0.000508,12,0.17441099999999998,0.0,0.003688
juniorbrasil,1,1,2,0,0.000459,11,0.180858,0.0,0.007759999999999999
koodaa,1,1,2,15,0.0008449999999999999,13,0.118769,0.0,0.002238
belcsantiago,1,2,3,24,0.000661,2,0.583333,8.0,0.001661
leonardopaiva,1,3,4,21,0.000409,11,0.180026,1020.681634,0.006749
petinformatica,1,1,2,6,0.00041900000000000016,10,0.181097,0.0,0.002571
caiochagas,1,1,2,12,0.000589,12,0.17435599999999998,0.0,0.004857
mangelis,1,1,2,8,0.000958,2,0.6,0.0,0.002327
andrefilipesz,1,1,2,8,0.000958,2,0.6,0.0,0.002327
JamessonCheron,1,2,3,16,0.000953,1,1.0,1.0,0.00129
amavlopes,1,1,2,12,0.000504,12,0.17856,0.0,0.004857
luanoliveira1992,1,1,2,12,0.0005780000000000001,11,0.15423599999999998,0.0,0.00219
danielcandidos,1,1,2,24,0.0005769999999999999,12,0.16505999999999998,0.0,0.002353
MatheusUehara,1,1,2,24,0.0005769999999999999,12,0.16505999999999998,0.0,0.002353
flavindias,1,1,2,14,0.000837,11,0.155593,0.0,0.003343
diegocamara,1,1,2,12,0.0005780000000000001,1,1.0,0.0,0.00219
gpb,1,2,3,3,0.0005139999999999999,12,0.166161,0.0,0.003688
aldeniolima,1,1,2,3,0.0005139999999999999,12,0.16611099999999998,0.0,0.003688
spider8,1,1,2,10,0.000453,1,1.0,10.857612,0.003056
RodrigoRodrigues7,1,1,2,11,0.00075,10,0.166363,0.0,0.002977
VanessaVieiraVV,1,4,5,13,0.000453,10,0.180739,1145.744627,0.003418
larislav,1,1,2,21,0.000624,12,0.158611,0.0,0.003609
jalexc,1,1,2,10,0.000669,12,0.16431800000000002,0.0,0.004528
frog789,1,1,2,7,0.0016079999999999998,13,0.14171199999999998,0.0,0.003321
GutenbergCarlos,1,1,2,21,0.000624,12,0.158611,0.0,0.003609
jonathasbsouza,1,2,3,15,0.001199,12,0.14759,2149.553571,0.003039
lauriavictor7,1,1,2,11,0.0006,10,0.177289,0.0,0.004704
vbsilva,1,1,2,15,0.000394,10,0.170398,144.19905500000004,0.002687
SilvaDecio,1,2,3,15,0.000629,10,0.186331,546.360492,0.007514
EduardoAmaral,1,1,2,7,0.0004,13,0.141969,0.0,0.002217
yeltsin,0,1,1,4,0.00032900000000000003,10,0.213287,0.0,0.0
angelobrito,0,2,2,0,0.00032900000000000003,11,0.188919,0.0,0.0
sflorencio,0,1,1,14,0.00032900000000000003,1,1.0,0.0,0.0
fracmt,0,1,1,0,0.00032900000000000003,12,0.130404,0.0,0.0
AvelinoGomez,0,1,1,16,0.00032900000000000003,1,1.0,0.0,0.0
tiagoalsilva,0,1,1,12,0.00032900000000000003,2,0.666667,0.0,0.0
sabrinagmcruz,0,1,1,7,0.00032900000000000003,1,1.0,0.0,0.0
willfelix,0,4,4,14,0.00032900000000000003,12,0.131023,0.0,0.0
tacionery,0,4,4,0,0.00032900000000000003,10,0.217512,0.0,0.0
wendeldesouza,0,1,1,-2,0.00032900000000000003,1,1.0,0.0,0.0
ClaytonRocha,0,1,1,16,0.00032900000000000003,1,1.0,0.0,0.0
phsg,0,1,1,14,0.00032900000000000003,1,1.0,0.0,0.0
KLEITONFREITAS,0,1,1,-2,0.00032900000000000003,1,1.0,0.0,0.0
aricardoreis,0,3,3,0,0.00032900000000000003,11,0.173228,0.0,0.0
phbritoo,0,1,1,21,0.00032900000000000003,13,0.134686,0.0,0.0
arthurmenezesb,0,1,1,6,0.00032900000000000003,1,1.0,0.0,0.0
VictorManoel,0,1,1,5,0.00032900000000000003,11,0.184043,0.0,0.0
klaytondeoliveira,0,1,1,5,0.00032900000000000003,11,0.184043,0.0,0.0
xewertonfilipe,0,3,3,21,0.00032900000000000003,11,0.188356,0.0,0.0
dashdanilo,0,1,1,5,0.00032900000000000003,11,0.184043,0.0,0.0
adelmojnr,0,1,1,5,0.00032900000000000003,11,0.184043,0.0,0.0
johnmaykbrito,0,2,2,7,0.00032900000000000003,12,0.185787,0.0,0.0
islanilton,0,1,1,-3,0.00032900000000000003,2,0.666667,0.0,0.0
feliperfmarques,0,3,3,2,0.00032900000000000003,11,0.17327,0.0,0.0
FranckAJ,0,1,1,12,0.00032900000000000003,2,0.666667,0.0,0.0
cConectando,0,3,3,17,0.00032900000000000003,9,0.207014,0.0,0.0
FlavioCastroFilho,0,2,2,17,0.00032900000000000003,11,0.180446,0.0,0.0
kevinbreaker,0,1,1,5,0.00032900000000000003,11,0.170391,0.0,0.0
andreximenes,0,5,5,12,0.00032900000000000003,10,0.219298,0.0,0.0
tiagocalisto,0,3,3,9,0.00032900000000000003,11,0.212766,0.0,0.0
rafamelima,0,1,1,9,0.00032900000000000003,11,0.212051,0.0,0.0
karollmm,0,1,1,9,0.00032900000000000003,11,0.212051,0.0,0.0
silvinhamorais,0,1,1,9,0.00032900000000000003,11,0.212051,0.0,0.0
MrRickSan,0,2,2,5,0.00032900000000000003,13,0.123711,0.0,0.0
arthurmagno,0,1,1,6,0.00032900000000000003,9,0.202508,0.0,0.0
joaoMonte,0,2,2,1,0.00032900000000000003,9,0.202802,0.0,0.0
adsonxzx,0,1,1,6,0.00032900000000000003,9,0.202508,0.0,0.0
thomascristanis,0,2,2,6,0.00032900000000000003,9,0.202808,0.0,0.0
AJS99,0,2,2,18,0.00032900000000000003,12,0.139594,0.0,0.0
BenjamimRodrigo,0,1,1,18,0.00032900000000000003,12,0.139375,0.0,0.0
mattvie,0,1,1,13,0.00032900000000000003,1,1.0,0.0,0.0
edigomes,0,1,1,-2,0.00032900000000000003,1,1.0,0.0,0.0
rodrigodma,0,1,1,6,0.00032900000000000003,9,0.202508,0.0,0.0
jonatascp,0,3,3,14,0.00032900000000000003,10,0.187138,0.0,0.0
felipealencar,0,1,1,6,0.00032900000000000003,9,0.202508,0.0,0.0
evandroabreu,0,1,1,0,0.00032900000000000003,2,0.666667,0.0,0.0
khurama,0,1,1,6,0.00032900000000000003,1,1.0,0.0,0.0
atriciasabino,0,1,1,6,0.00032900000000000003,9,0.202508,0.0,0.0
douglasventura,0,1,1,6,0.00032900000000000003,9,0.202508,0.0,0.0
diegobarcelar,0,1,1,0,0.00032900000000000003,10,0.211479,0.0,0.0
lumaneto,0,1,1,9,0.00032900000000000003,11,0.212051,0.0,0.0
atilarec,0,1,1,14,0.00032900000000000003,1,1.0,0.0,0.0
sheylacanutobf,0,2,2,9,0.00032900000000000003,11,0.214094,0.0,0.0
victoraldabalde,0,1,1,-2,0.00032900000000000003,1,1.0,0.0,0.0
guilherme77,0,1,1,-2,0.00032900000000000003,1,1.0,0.0,0.0
phrps,0,2,2,13,0.00032900000000000003,12,0.139482,0.0,0.0
shoesthe6,0,1,1,-2,0.00032900000000000003,1,1.0,0.0,0.0
mateusnbm,0,1,1,13,0.00032900000000000003,1,1.0,0.0,0.0
santojon,0,3,3,17,0.00032900000000000003,1,1.0,0.0,0.0
Makqsi,0,1,1,-2,0.00032900000000000003,1,1.0,0.0,0.0
allansid,0,1,1,-3,0.00032900000000000003,2,0.666667,0.0,0.0
alanav120,0,1,1,-2,0.00032900000000000003,1,1.0,0.0,0.0
Suburbanno,0,2,2,9,0.00032900000000000003,11,0.215972,0.0,0.0
igorsimoes,0,1,1,-2,0.00032900000000000003,1,1.0,0.0,0.0
warkentien2,0,1,1,0,0.00032900000000000003,10,0.211479,0.0,0.0
Galtvan,0,1,1,0,0.00032900000000000003,10,0.211479,0.0,0.0
Jeffguitar,0,1,1,11,0.00032900000000000003,12,0.165511,0.0,0.0
andreguigo,0,1,1,6,0.00032900000000000003,10,0.17994100000000002,0.0,0.0
leoamf,0,2,2,10,0.00032900000000000003,11,0.181009,0.0,0.0
edunjr,0,1,1,9,0.00032900000000000003,1,1.0,0.0,0.0
LucasLJorge,0,1,1,-2,0.00032900000000000003,1,1.0,0.0,0.0
moisespalma,0,4,4,7,0.00032900000000000003,2,0.833333,0.0,0.0
daniellyqueiroz,0,1,1,-2,0.00032900000000000003,1,1.0,0.0,0.0
chgsilva,0,1,1,6,0.00032900000000000003,1,1.0,0.0,0.0
C0balto,0,1,1,2,0.00032900000000000003,1,1.0,0.0,0.0
jandui,0,1,1,-2,0.00032900000000000003,1,1.0,0.0,0.0
ignispider,0,1,1,9,0.00032900000000000003,1,1.0,0.0,0.0
rcag2,0,1,1,13,0.00032900000000000003,13,0.119322,0.0,0.0
Heyzeh,0,1,1,13,0.00032900000000000003,11,0.15313800000000002,0.0,0.0
ArthurLapprand,0,1,1,6,0.00032900000000000003,10,0.184352,0.0,0.0
FernandoRLCruz,0,1,1,14,0.00032900000000000003,12,0.162956,0.0,0.0
rsaRodrigoSales,0,1,1,-2,0.00032900000000000003,1,1.0,0.0,0.0
abelb0rges,0,3,3,6,0.00032900000000000003,10,0.184874,0.0,0.0
brmedeiros,0,1,1,9,0.00032900000000000003,12,0.154257,0.0,0.0
andrelarruda,0,2,2,10,0.00032900000000000003,3,0.555556,0.0,0.0
lrsilva,0,1,1,12,0.00032900000000000003,12,0.17456300000000002,0.0,0.0
leonardoaraujo85,0,2,2,-3,0.00032900000000000003,1,1.0,0.0,0.0
giovanebribeiro,0,3,3,10,0.00032900000000000003,1,1.0,0.0,0.0
lgallindo,0,1,1,-2,0.00032900000000000003,1,1.0,0.0,0.0
pedrovsra,0,1,1,6,0.00032900000000000003,10,0.18541,0.0,0.0
jpedrocm,0,3,3,6,0.00032900000000000003,10,0.201838,0.0,0.0
dapine,0,1,1,10,0.00032900000000000003,1,1.0,0.0,0.0
aeciojr,0,1,1,7,0.00032900000000000003,3,0.5,0.0,0.0
felipechaulet,0,1,1,0,0.00032900000000000003,10,0.192227,0.0,0.0
celsonrd,0,1,1,12,0.00032900000000000003,11,0.153224,0.0,0.0
gtgsantos,0,3,3,5,0.00032900000000000003,12,0.17134000000000002,0.0,0.0
petermademann,0,1,1,14,0.00032900000000000003,1,1.0,0.0,0.0
tamiresa,0,4,4,10,0.00032900000000000003,11,0.2189,0.0,0.0
GabrielVanderlei,0,3,3,13,0.00032900000000000003,10,0.176755,0.0,0.0
gugaemc,0,1,1,5,0.00032900000000000003,12,0.155524,0.0,0.0
arcelo,0,1,1,5,0.00032900000000000003,12,0.155524,0.0,0.0
krixapolinario,0,1,1,-2,0.00032900000000000003,1,1.0,0.0,0.0
henriquemc,0,3,3,5,0.00032900000000000003,10,0.192429,0.0,0.0
rafaelborja,0,1,1,-2,0.00032900000000000003,1,1.0,0.0,0.0
Jemesson,0,6,6,6,0.00032900000000000003,9,0.228726,0.0,0.0
tomazhawkjr,0,1,1,15,0.00032900000000000003,14,0.114208,0.0,0.0
ubmit,0,1,1,-2,0.00032900000000000003,1,1.0,0.0,0.0
andrewesteves,0,1,1,5,0.00032900000000000003,10,0.166414,0.0,0.0
licensed,0,1,1,33,0.00032900000000000003,1,1.0,0.0,0.0
felipehmsilveira,0,1,1,11,0.00032900000000000003,9,0.197981,0.0,0.0
r4ddek,0,2,2,33,0.00032900000000000003,1,1.0,0.0,0.0
davilmaster,0,1,1,20,0.00032900000000000003,1,1.0,0.0,0.0
tiagollalmeida,0,1,1,0,0.00032900000000000003,10,0.206702,0.0,0.0
ViniFlira,0,1,1,9,0.00032900000000000003,11,0.186862,0.0,0.0
filipehsilva,0,1,1,0,0.00032900000000000003,10,0.219337,0.0,0.0
fernandofragoso,0,1,1,-2,0.00032900000000000003,1,1.0,0.0,0.0
progerbr,0,1,1,0,0.00032900000000000003,11,0.194405,0.0,0.0
WesleyJw,0,1,1,0,0.00032900000000000003,11,0.194405,0.0,0.0
Eviomarcio,0,2,2,20,0.00032900000000000003,1,1.0,0.0,0.0
bernardoreis,0,1,1,9,0.00032900000000000003,12,0.159084,0.0,0.0
brunover,0,1,1,5,0.00032900000000000003,10,0.166414,0.0,0.0
italoj,0,1,1,4,0.00032900000000000003,10,0.204165,0.0,0.0
cauannelinhares,0,2,2,15,0.00032900000000000003,11,0.172036,0.0,0.0
isaacdias,0,1,1,0,0.00032900000000000003,1,1.0,0.0,0.0
vinimoraesrc,0,2,2,6,0.00032900000000000003,11,0.169759,0.0,0.0
jbsn94,0,1,1,6,0.00032900000000000003,1,1.0,0.0,0.0
palaciowagner,0,2,2,15,0.00032900000000000003,14,0.114393,0.0,0.0
thomastbb,0,1,1,6,0.00032900000000000003,1,1.0,0.0,0.0
beugenio,0,1,1,-2,0.00032900000000000003,1,1.0,0.0,0.0
ThiagoAquino,0,2,2,6,0.00032900000000000003,2,0.75,0.0,0.0
Jcns,0,1,1,6,0.00032900000000000003,1,1.0,0.0,0.0
kassioribeiro,0,1,1,0,0.00032900000000000003,11,0.174452,0.0,0.0
hugolhmartins,0,1,1,14,0.00032900000000000003,10,0.182635,0.0,0.0
jorgemarc,0,1,1,21,0.00032900000000000003,1,1.0,0.0,0.0
rpss2,0,1,1,6,0.00032900000000000003,12,0.135188,0.0,0.0
jvog,0,1,1,-2,0.00032900000000000003,1,1.0,0.0,0.0
DwarfThief,0,1,1,22,0.00032900000000000003,3,0.5,0.0,0.0
alexandreclayton,0,1,1,5,0.00032900000000000003,11,0.188465,0.0,0.0
